R 1920 1080
NO ./textures/bluestone.xpm
SO ./textures/redbrick.xpm
WE ./textures/colorstone.xpm
EA ./textures/greystone.xpm
S ./textures/barrel.xpm
F 0,100,255
C 225,30,0

   1111111111111111 11111111111111   111111111       
   1     1000000001 10000000000001   100000001
   11111 1011000001110000002000001   100000001
         1001000000000000000000001   100000001
 111111111011000001110000000000001   100000001
 100000000011000001110111111111111   111111111
 11110111111111011100000012221
 11110111111111011101010010201
 11000000110100011100000010001
 10002000000000001100000000001
 10000000000000001101010010001
 11000001110101011111011110N0111
 11110111 1010101 100010000001
 11111111 1111111 111111111111
                                             



